003,002,003,014,022,025,047,
002,009,145,025,079,010,005,
005,010,090,082,070,023,080,
003,002,003,014,022,025,047,
003,002,003,014,022,025,047,
003,002,003,014,022,025,047,