LevelType: 1
RRRRRRRRRRRRRRRRRRRRRRRRRRRRRRRRRRRRRRRRRRRRRRRRRRRRRRRRRRRRRRRRRRRRRRRRRRRRRRRRRRRRRRRRRRRRRRRRRRRRRRRRRRRRR
R...........................................................................................................R
R...........................................................................................................R
R............................................@..............................................................R
R...........................................................................................................R
R...........RRRGRGRRR.....RRRRGGRRRR................LGGLBBBBLGGLBBBBLGGL....................................R
R...........R.......R.....G........L................L....B........B....L........BBBGBBGBBGBB.BBGBBGBBGBBB...R
R...........R.......L.....L.........................G....B........B....G........B......B.........B......B...R
R...........R......................L................B....B........B....B........BBBBBB.............BBBBBB...R
R...........R.......L.....L...RRRRRR.....................B........B.............L.......................L...R
R...........RRRGRGRRR.....G........R................B....BBBL..LBBB....B....................................R
R.........................RRRRGGRRRR................G..................G....................................R
R...................................................L..................L........L.......................L...R
R...................................................LGGLBBBBL..LBBBBLGGL........B.......................B...R
R...............................................................................B.......................B...R
R...............................................................................BBBGBBGBBGBB.BBGBBGBBGBBB...R
R...........................................................................................................R
R.............................................................BBGGBL..LBGGBB................................R
R..........LLLLLGGGLLLLLLLLLLLLGGGLLLL......BGBBGB............B............B................................R
R..........L............L............L......B....B............B............B................................R
R..........G............L............G......B....G............L............L................................R
R..........LLLLLLL.LLLLLLLLLLL.LLLLLLL...........G..........................................................R
R...........................................B....B............L............L................................R
R...........................................BGBBGB............B............B................................R
R..........LLLL.LLLLLLLL.LLLLLLLL.LLLL........................B............B................LLB.BLL.........R
R..........G.......L.........L.......G........................BBGGBL..LBGGBB................B.....B.........R
R..........L.......L.........L.......L............................................................B.........R
R..........LLLL.LLLLLLLL.LLLLLLLL.LLLL......RRR.RRR.........................................B...............R
R...........................................R.....R.........................................B.....B.........R
R...........................................................................................LLB.BLL.........R
R...........................................R.....R.........................................................R
RRRRRRRRRRRRRRRRRRRRRRRRRRRRRRRRRRRRRRRRRRRRRRRRRRRRRRRRRRRRRRRRRRRRRRRRRRRRRRRRRRRRRRRRRRRRRRRRRRRRRRRRRRRRR
